111111111111111
1P0000000C00001
1F1110111111101
10C000C010001C1
101110111110111
101000000000001
1F111F110110111
1C0C000C000CE01
111111111111111
