111111111
11F001011
10P0F0011
110000111
1111C1111
10F0C00E1
1110F1011
111111111