111111111
1P0CE0C01
100000001
111111111