111111111
1P0C000C1
10000FEF1
111111111