111111111
10P00C001
100C00011
110000111
1111C1111
100C000E1
1110C1011
111111111