111111111
100000001
1P00F00C1
100000E01
111111111