111111111111
1P0C000C0001
100000E00001
111111111111