111111111
101000101
1P0000011
110000111
1111C1111
1000000E1
111001011
111111111