111111111111111111111111111
1P00C000000C000000000010C01
100000100000011000000010001
100C00100000000000111110001
100000111100000000000000001
100C000C00000010000000001E1
111111111111111111111111111