111111111
11F1P1011
101F00E11
100010111
1111CC011
100010CF1
1110F1011
111111111